NO ./textures/g4.xpm
SO ./textures/g3.xpm
WE ./textures/g2.xpm
EA ./textures/g1.xpm

C 0,0,0
F 21,21,20

1111111111111111111111111111111111111111111111111111
1000000000000000000000000000000000000000000000000001
1000000000000000001111000000000111111111111000000001
1000000000000000011110000000000111110011111000000001
1000000000000000111100000000000111100011111000000001
1000000000000001111000000000000111000011111000000001
1000000000000011110000000000000110000011111000000001
1000000000000111100000000000000000000111110000000001
100000000000111100000000000N000000001111100000000001
1000000000011110000000000000000000011111000000000001
1000000000111100000000000000000000111110000000000001
1000000001111111111111111100000001111100011000000001
1000000001111111111111111100000111111000111000000001
1000000000000000000001111100000111111001111000000001
1000000000000000000001111100000111111111111000000001
1000000000000000000001111100000000000000000000000001
1000000000000000000000000000000000000000000000000001
1111111111111111111111111111111111111111111111111111
