NO ./textures/ale1.xpm
SO ./textures/marco1.xpm
WE ./textures/ale1.xpm
EA ./textures/andre.xpm

C 173,216,230
F 191,232,119

        1111111111111111111111111
        1000000000110000000000001
        1011000000110000000000001
        10010000000D0000000000001
111111111011000001110000000000001
100000000011000001111011111111111
11110111111111011100000010001
11110111111111N11101010010001
11111111111111111111111111111
11111111111111111111111111111
11000000110101011100000010001
10000000000000000000000010001
10000000000000001101010010001
1100000111010101111101111000111
11110111 1110101 101111110001
11111111 1111111 111111111111
