NO ./path_to_the_north_texture
SO ./path_to_the_south_texture
WE ./path_to_the_west_texture
EA ./path_to_the_east_texture

C 173,216,230
F 191,232,139

11111111111111111111111111111
10000000000000000000000000001
10000000000000000000000000001
11111111111000000011111111111
10000000000000000000000000001
10000000000000000000000000001
10000000000000000000000000001
10000000000000000000000000001
10000000000000E00000000000001
10000000000000000000000000001
11111111111111111111111111111
