NO ./textures/g4.xpm
SO ./textures/g3.xpm
WE ./textures/g2.xpm
EA ./textures/g1.xpm

C 0,0,0
F 21,21,20

1111111111111111
10000000000000W1
10011D11111D1111
100D000001000001
1001111001001001
100100D001001001
1001001001001111
1001001001001001
1001001001001001
100100100100D001
1111111111111111
