NO ./textures/g4.xpm
SO ./textures/g3.xpm
WE ./textures/g2.xpm
EA ./textures/g1.xpm

C 58,35,3
F 191,232,119

        1111111111111111111111111
        1000000000110000000000001
        1011000000110000000000001
        100100000000000W000000001
111111111011000001110000000000001
100000000011000001111111111111111
11110111111111011100000010001
11110111111111011101010010001
11000000110101011100000010001
10000000000000001100000010001
10000000000000001101010010001
1100000111010101111101111000111
11110111 1110101 101111010001
11111111 1111111 111111111111
