NO ./textures/special/l2.xpm
SO ./textures/special/l5.xpm
WE ./textures/special/l6.xpm
EA ./textures/special/l11.xpm

C 0,0,83
F 1,50,32

        1111111111111111111111111
        100D000000010000000000001
        1011000000010000000000001
        10010000000D000W000000001
111111111011000001110000000000001
1000000D0011000001111111111111111
11110111111111011100000010001
11110111111111011101010010001
11000000110101011100000010001
10000000000000001100000010001
10000000000000001101010010001
1100000111010101111101111000111
11110111 1110101 101111010001
11111111 1111111 111111111111
