NO ./textures/foco.xpm
SO ./textures/wall_3.xpm
WE ./textures/tnt.xpm
EA ./textures/wall_1.xpm

C 0,0,0
F 1,142,66

11111111111111111111111111111
10000000000000000000000000001
10000000000000000000000000001
11111111111000000011111111111
10000000000000000000000000001
10000000000000000000000000001
10000000000000000000000000001
10000000000000000000000000001
10000000000000N00000000000001
10000000000000000000000000001
11111111111111111111111111111
