NO ./textures/g4.xpm
SO ./textures/g3.xpm
WE ./textures/g2.xpm
EA ./textures/culo.xpm

C 173,216,230
F 191,232,139

111111111111111
100000000000001
10000000W000001
111111111111111
